1 8 
4
3 1 1
0 4 1
1 5 5
2 7 1
10 10
1 1 1 1 1 1 1 1 1 1
1 0 1 0 0 0 0 0 0 1
1 0 0 0 1 1 0 1 0 1
1 0 1 1 1 1 0 1 0 1
1 0 1 0 0 0 0 1 0 1
1 6 0 9 1 0 1 1 0 1
1 0 1 1 0 0 1 0 0 1
1 0 1 8 0 0 1 0 1 1
1 2 1 4 1 1 1 0 3 1
1 1 1 1 1 1 1 1 1 1