8 8
4
3 5 3
1 3 5
0 1 2
2 2 1
10 10
1 1 1 1 1 1 1 1 1 1
1 3 0 0 0 0 0 0 0 1
1 0 1 1 1 0 1 1 5 1
1 0 0 1 1 0 0 1 5 1
1 1 0 0 1 0 0 1 8 1
1 7 1 0 6 1 0 0 1 1
1 0 0 0 1 9 1 0 0 1
1 0 1 1 1 0 0 1 0 1
1 0 0 0 0 0 0 0 2 1
1 1 1 1 1 1 1 1 1 1
